#domain
hospital
#levelname
adv_box_problem
#colors
blue: 0, B
#initial
+++++++++++++++++
+0              +
+          B    +
+++++++++++++++++
#goal
+++++++++++++++++
+        B      +
+               +
+++++++++++++++++
#end
